################
#..............#
#..............#
#.....####.....#
#..............#
#..##......##..#
#..#........#..#
#..............#
#..............#
#..#........#..#
#..##......##..#
#..............#
#.....####.....#
#..............#
#..............#
################