################
#......#.......#
#......#.......#
#...#.....###..#
#..##..........#
#..............#
#..............#
#...###..#.....#
#.....#..###...#
#..............#
#..............#
#..........##..#
#..###.....#...#
#.......#......#
#.......#......#
################