################
#..............#
#..............#
#..###...#.....#
#..#.....#.....#
#..#.....####..#
#..#..#..#.....#
#.....#..#.....#
#.....#..#.....#
#.....#..#..#..#
#..####.....#..#
#.....#.....#..#
#.....#...###..#
#..............#
#..............#
################